####################
#........#...##...##
#######.##....##.#.#
#######.##.######.##
#...##.............#
###.##.#.#.##.##.#.#
###....#.#.##..#.#.#
#...##.#.#.######.##
##.###.#.#.........#
#........#########.#
#######.########...#
#######.#########.##
#...##...########.##
###.##.#.########.##
###....#.#........##
#...##.#....#####.##
##.###.#.##.###...##
####################