1111111111
1000000001
1111111011
1111111011
1000110001
1110110101
1110000101
1000110101
1101110101
1111111111