##########
#........#
#######.##
#######.##
#...##...#
###.##.#.#
###....#.#
#...##.#.#
##.###.#.#
##########