######################################
#......###.......##############....###
####.#....####.######.###...######.###
####...##.####............########.###
#....###########..######..##.......###
####........#####........###.#.#######
###...###.####....##.###.....#.......#
#####........#######.####.########.###
#####.###.##.######.......#####.#..###
#####.###.##........#####.#####.#.####
#####.###.#######.#######.......######
#......###.......##############....###
####.#....####.######.###...######.###
####...##.####............########.###
#....###########..######..##.......###
####........#####........###.#.#######
###...###.####....##.###.....#.......#
#####........#######.####.########.###
#####.###.##.######.......#####.#..###
#####.###.##........#####.#####.#.####
#####.###.#######.#######.......######
#########.........#############.###.##
#########.#######.#############.###.##
#.........#######.#############.....##
#.###########...................######
######################################